EA ./textures/Dsite42_800x800.xpm
WE ./textures/stonewall000.xpm
SO ./textures/brick_2.xpm
NO ./textures/arafa-spider.xpm

F 220,100,0
C 225,30,1

1111111111111111111111111
1000000000110000000000001
1011000001110000000000001
1001000000000000000000001
111111111011000001110000100000000
100000000011000001110111111111111
11110111111111011100000010001
11110111111111011101010010001
11000000110101011100000010001
10000000000000001100000010001
10000000000000001101010010001
1100000111S10101111101111000111
11110111 1110101 101111010001
11111111 1111111 111111111111