EA ./textures/monalisa.xpm
WE ./textures/stonewall000.xpm
SO ./textures/brick_2.xpm
NO ./textures/arafa-spider.xpm

F 128,128,128
C 0,0,0

1111111111111111111111111111
1000000000010000001000000001
1011111111011111111011111111
1000000001000000000000000001
1111111111111111111111111101
1000000001000000000000000001
1001111111011111111001111101
1001111111011111111001111101
1001000001000000001001000001
1001000001000000001001000001
1001111111011111111001111101
1001111111011111111001111101
1001000000000000001001000001
1001111111011111111001111101
1001111111011111111001111101
1000000001000000000000000001
1000000001000000000000000001
1001111111011111111001111101
1001111111011111111001111101
1001000001000000001001000001
1001000001000000001001000001
10011111110111111110N1111101
1001111111011111111001111101
1000000000010000001000000001
1111111111111111111111111111
