NO ./textures/Dsite42_800x800.xpm
WE ./textures/Dsite42_800x800.xpm
SO ./textures/Dsite42_800x800.xpm
EA ./textures/Dsite42_800x800.xpm

F 220,100,0
C 225,30,0

1111111111
1001000001
1000001001
1001000011
1000000001
10N0001001
1000000001
1111111111
