EA ./textures/monalisa.xpm
WE ./textures/stonewall000.xpm
SO ./textures/brick_2.xpm
NO ./textures/arafa-spider.xpm

F 128,128,128
C 0,0,0

1111111
1000001
1000001
1000001
10000N1
1111111
